#Bugfix
Black Steel-->玄铁
Frame Box-->框架
#Items
Plage-->板
Ingot-->锭
Soldering Alloy-->焊锡
Alloy-->合金
Ore-->矿石
Dust-->粉末
Wire-->线缆(未绝缘)

Cable-->线缆
Stone-->石头

#Abscract
Max-->最大
Voltage-->电压
Amperage-->电流
FuelEfficiency-->燃烧效率
Loss/Meter/Ampere-->损耗

#Describe
Tiny Pile of-->很小一撮
Small Pile of -->一小撮
Small(?=.{0,512}Ore)-->贫瘠的
Stainless -->不锈
Red-->红色
Blue-->蓝色
Yellow-->黄色
Black-->黑色
Fluxed-->熔融
Infused-->附魔
Enriched-->浓缩
Astral-->陨

#Elements
Hydrogen-->氢
Carbon-->碳
Plutonium 244-->钚-244
Deuterium-->氘
Tritium-->氚
Helium-->氦
Helium-3-->氦-3
Lithium-->锂
Beryllium-->铍
Boron-->硼
Plutonium 241-->钚-241
Nitrogen-->氮
Oxygen-->氧
Fluorine-->氟
Sodium-->钠
Magnesium-->镁
Aluminium-->铝
Silicon-->硅
Phosphor-->磷
Sulfur-->硫
Chlorine-->氯
Argon-->氩
Potassium-->钾
Calcium-->钙
Scandium-->钪
Titanium-->钛
Vanadium-->钒
Americium-->镅
Chrome-->铬
Manganese-->锰
Iron-->铁
Cobalt-->钴
Nickel-->镍
Copper-->铜
Zinc-->锌
Gallium-->镓
Arsenic-->砷
Rubidium-->铷
Strontium-->锶
Yttrium-->钇
Niobium-->铌
Molybdenum-->钼
Palladium-->钯
Silver-->银
Cadmium-->镉
Indium-->铟
Tin-->锡
Antimony-->锑
Tellurium-->碲
Caesium-->铯
Barium-->钡
Lanthanum-->镧
Cerium-->铈
Praseodymium-->镨
Neodymium-->钕
Promethium-->钷
Samarium-->钐
Europium-->铕
Gadolinium-->钆
Terbium-->铽
Dysprosium-->镝
Holmium-->钬
Erbium-->铒
Thulium-->铥
Ytterbium-->镱
Lutetium-->镏
Tantalum-->钽
Tungsten-->钨
Osmium-->锇
Iridium-->铱
Platinum-->铂
Gold-->金
Mercury-->汞
Lead-->铅
Bismuth-->铋
Radon-->氡
Thorium-->钍
Uranium 235-->铀-235
Uranium 238-->铀-238
Neutronium-->中子元素
Bronze-->青铜
Brass-->黄铜
Invar-->因瓦合金
Electrum-->琥珀金
Pig-->生
Wrought-->熟
Steel-->钢
Cupronickel-->白铜
Nichrome-->镍铬
Kanthal-->坝塔尔
Magnalium-->镁铝
Battery-->电池
Tungstensteel-->钨钢
Osmiridium-->铱锇合金
Sunnarium-->太阳能聚合物
Enderium-->末影
HSLA-->HSLA
Naquadah-->硅岩金属
Naquadria-->硅岩金属化合物
Duranium-->钍瑞铌
Tritanium-->三钛合金
Thaumium-->神秘锭
Mithril-->秘银
Midasium-->点金素
















#Remove empty space
 -->
